┌ ─ ─ ─ ─ ─ ─ ─ ─ ─ ─ ─ ─ ─ ─ ─ ─ ─ ─ ─ ┐
│ · · · · · · │ ≡ ≡ ≡ ≡ ≡ ≡ ≡ │ ≡ ≡ ≡ ≡ │
│ ≡ ┌ ─ ┐ ≡ ┌ ┘ ┌ ─ ┐ ≡ ┌ ┐ ≡ │ ≡ ┌ ┐ ≡ │
│ ≡ └ ┐ │ ≡ │ ≡ ≡ ≡ │ ≡ │ │ ≡ │ ≡ │ │ ≡ │
│ ─ ┐ │ └ ┐ └ ┐ ┌ ─ ┘ ≡ └ ┘ ≡ ┘ ≡ └ ┘ ≡ │
│ ≡ │ └ ┐ │ ≡ │ │ ≡ ≡ ≡ ≡ ≡ ≡ ≡ ≡ ≡ ≡ ≡ │
│ ≡ └ ┐ │ │ ≡ └ ┘ ≡ ┌ ─ ┐ ≡ ┌ ─ ┐ ┌ ─ ┐ │
│ ─ ┐ │ │ ─ ┐ ┌ ┘ ≡ │ ≡ │ ≡ │ ≡ ┐ │ ─ ┘ │
│ ≡ │ │ │ ≡ │ │ ≡ ≡ │ ≡ │ ≡ │ ≡ │ │ ≡ ≡ │
│ ≡ └ └ ┘ ≡ └ ┘ ≡ ┌ ─ ─ ┘ ≡ └ ─ ┘ └ ┘ ≡ │
│ ─ ─ ─ ─ └ ─ ┐ │ ≡ ≡ ≡ ≡ ≡ ≡ ≡ ≡ ≡ ≡ ≡ │
│ ≡ ≡ ≡ ≡ │ ≡ │ │ ┌ ─ ─ ┐ ┌ ─ ┐ ┌ ┐ ≡ ≡ │
│ ≡ ┌ ─ ─ ┘ ≡ └ ┘ │ ≡ ≡ │ │ ≡ │ │ └ ┐ ≡ │
│ ≡ │ ≡ ≡ ≡ ≡ ≡ ≡ ≡ ≡ ≡ ≡ ≡ ≡ ≡ │ ≡ │ ≡ │
└ ─ ─ ─ ─ ─ ─ ─ ─ ─ ─ ─ ─ ─ ─ ─ ─ ─ ─ ─ ┘