╔ ─ ─ ─ ─ ─ ─ ─ ─ ─ ─ ─ ─ ─ ─ ─ ─ ─ ─ ─ ─ ─ ─ ─ ─ ─ ─ ─ ─ ─ ─ ─ ─ ─ ─ ─ ─ ─ ─ ─ ─ ─ ─ ─ ─ ─ ─ ─ ─ ─ ─ ─ ─ ─ ─ ─ ─ ─ ─ ─ ─ ─ ─ ╗
│ · · · · · · · · · · · · · · · · · · · · · · · · · · · · · · · · · · · · · · · · · · · · · · · · · · · · · · · · · · · · · · │
│ · · · · · · · · · · · · · · · · · · · · · · · · · · · · · · · · · · · · · · · · · · · · · · · · · · · · · · · · · · · · · · │
│ · · · · · · · · · · · · · · · · · · · · · · · · · · · · · · · · · · · · · · · · · · · · · · · · · · · · · · · · · · · · · · │
│ · · · · · · · · · · · · · · · · · · · · · · · · · · · · · · · · · · · · · · · · · · · · · · · · · · · · · · · · · · · · · · │
│ · · · · · · · · · · · · · · · · · · · · · · · · · · · · · · · · · · · · · · · · · · · · · · · · · · · · · · · · · · · · · · │
│ · · · · · · · · · · · · · · · · · · · · · · · · · · · · · · · · · · · · · · · · · · · · · · · · · · · · · · · · · · · · · · │
│ · · · · · · · · · · · · · · · · · · · · · · · · · · · · · · · · · · · · · · · · · · · · · · · · · · · · · · · · · · · · · · │
│ · · · · · · · · · · · · · · · · · · · · · · · · · · · · · · · · · · · · · · · · · · · · · · · · · · · · · · · · · · · · · · │
│ · · · · · · · · · · · · · · · · · · · · · · · · · · · · · · · · · · · · · · · · · · · · · · · · · · · · · · · · · · · · · · │
│ · · · · · · · · · · · · · · · · · · · · · · · · · · · · · · · · · · · · · · · · · · · · · · · · · · · · · · · · · · · · · · │
│ · · · · · · · · · · · · · · · · · · · · · · · · · · · · · · · · · · · · · · · · · · · · · · · · · · · · · · · · · · · · · · │
│ · · · · · · · · · · · · · · · · · · · · · · · · · · · ┏ _ ╸ ┅ ┅ ╺ _ ┓ · · · · · · · · · · · · · · · · · · · · · · · · · · · │
│ · · · · · · · · · · · · · · · · · · · · · · · · · · · ] ≡ ≡ ≡ ≡ ≡ ≡ [ · · · · · · · · · · · · · · · · · · · · · · · · · · · │
│ · · · · · · · · · · · · · · · · · · · · · · · · · · · ] ≡ ≡ ≡ ≡ ≡ ≡ [ · · · · · · · · · · · · · · · · · · · · · · · · · · · │
│ · · · · · · · · · · · · · · · · · · · · · · · · · · · ] ≡ ≡ ≡ ≡ ≡ ≡ [ · · · · · · · · · · · · · · · · · · · · · · · · · · · │
│ · · · · · · · · · · · · · · · · · · · · · · · · · · · ┗ ⎻ ⎻ ⎻ ⎻ ⎻ ⎻ ┛ · · · · · · · · · · · · · · · · · · · · · · · · · · · │
│ · · · · · · · · · · · · · · · · · · · · · · · · · · · · · · · · · · · · · · · · · · · · · · · · · · · · · · · · · · · · · · │
│ · · · · · · · · · · · · · · · · · · · · · · · · · · · ┌ ─ ─ ─ ─ ─ ─ ┐ · · · · · · · · · · · · · · · · · · · · · · · · · · · │
│ · · · · · · · · · · · · · · · · · · · · · · · · · · · └ ─ ─ ┐ ┌ ─ ─ ┘ · · · · · · · · · · · · · · · · · · · · · · · · · · · │
│ · · · · · · · · · · · · · · · · · · · · · · · · · · · · · · │ │ · · · · · · · · · · · · · · · · · · · · · · · · · · · · · · │
│ · · · · · · · · · · · · · · · · · · · ┌ ─ ─ ┐ · ┌ ─ ─ ─ ┐ · │ │ · ┌ ─ ─ ─ ┐ · ┌ ─ ─ ┐ · · · · · · · · · · · · · · · · · · · │
│ · · · · · · · · · · · · · · · · · · · └ ─ ┐ │ · └ ─ ─ ─ ┘ · └ ┘ · └ ─ ─ ─ ┘ · │ ┌ ─ ┘ · · · · · · · · · · · · · · · · · · · │
│ · · · · · · · · · · · · · · · · · · · · · │ │ · · · · · · · ≡ ≡ · · · · · · · │ │ · · · · · · · · · · · · · · · · · · · · · │
│ · · · · · · · · · · · · · · · · · · · · · │ │ · ┌ ┐ · ┌ ─ ─ ─ ─ ─ ─ ┐ · ┌ ┐ · │ │ · · · · · · · · · · · · · · · · · · · · · │
│ · · · · · · · · · · · · · · · · · · · · · └ ┘ · │ │ · └ ─ ─ ┐ ┌ ─ ─ ┘ · │ │ · └ ┘ · · · · · · · · · · · · · · · · · · · · · │
│ · · · · · · · · · · · · · · · · · · · · · · · · │ │ · · · · │ │ · · · · │ │ · · · · · · · · · · · · · · · · · · · · · · · · │
│ · · · · · · · · · · · · · · · · · · · ┌ ─ ─ ─ ─ ┘ └ ─ ─ ┐ · │ │ · ┌ ─ ─ ┘ └ ─ ─ ─ ─ ┐ · · · · · · · · · · · · · · · · · · · │
│ · · · · · · · · · · · · · · · · · · · └ ─ ─ ─ ─ ─ ─ ─ ─ ┘ · └ ┘ · └ ─ ─ ─ ─ ─ ─ ─ ─ ┘ · · · · · · · · · · · · · · · · · · · │
│ · · · · · · · · · · · · · · · · · · · · · · · · · · · · · · · · · · · · · · · · · · · · · · · · · · · · · · · · · · · · · · │
╚ ─ ─ ─ ─ ─ ─ ─ ─ ─ ─ ─ ─ ─ ─ ─ ─ ─ ─ ─ ─ ─ ─ ─ ─ ─ ─ ─ ─ ─ ─ ─ ─ ─ ─ ─ ─ ─ ─ ─ ─ ─ ─ ─ ─ ─ ─ ─ ─ ─ ─ ─ ─ ─ ─ ─ ─ ─ ─ ─ ─ ─ ─ ╝